######## #########
#......###.......#############
#......|.|.......|...........#
#......###.......###########.#
######## ####|####         #.#################
            #.#            #.|...............#
            #.#            #.###############.#
            #.#            #.#             #.# 
            #.#            #.#             #.#
            #.#            #.#             #.#
            #.#            #.#             #.#
            #.#            #.#             #.#
#############|##############|###############|#############
#........................................................#
#........................................................#
#........................................................#
#........................................................#
#........................................................#
#@................R......................................#
#.................S......................................#
#........................................................#
#........................................................#
#........................................................#
#........................................................#
##########################################################