######## #########
#......###.......#
#......|.|.......#
#......###.......#
######## ####|####
            #.#            
            #.#            
            #.#            
            #.#            
            #.#            
            #.#            
            #.#            
#############.############################################
#........................................................#
#........................................................#
#........................................................#
#........................................................#
#........................................................#
#........................................................#
#........................................................#
#........................................................#
#........................................................#
#........................................................#
#........................................................#
##########################################################